xxxxxxxxxxxxxxxxxxxx
x@------M----x-----x
x-xxxx-xxxxx-x-xxx-x
x-x----x---x-x-x-x-x
x-x-xxx-xxx-x-x-x--x
x-x---x---x---x-x-xx
x-xxx-xxx-xxxxx-x-xx
x-----x---x-----x-xx
xxxxx-xxx-x-xxxxx-xx
x---x---x---x-----xx
x-x-xxx-xxxxx-xxx-xx
x-x-------x-------xx
x-xxx-xxx-xxx-xxx-xx
x-----x---x---x---xx
x-xxx-xxx-xxx-xxx-xx
x-x---x-------x---xx
x-x-xxx-xxxxx-xxx-xx
x-x-----x---------xx
x-xxxxx-xxxxxxxxxxxx
x------M-------Exxxx
xxxxxxxxxxxxxxxxxxxx